24 15 80
VV1VV121VVVVV121VV1VVVVV
VVVVVVVVVVMVVV1VVVVVVV1V
V1VJKLVVVVJKLVVVVVVABCVV
VMVVVVVVVVVVVVVVVVVGHIVV
JKKLVV1VVVV1VVA11CVV1VV1
VV1VVVVVVABCVVGHHIVV2VVA
VVVVVJLVVDEFVVVVVVVV1VVG
VVVVVVVVVGHIVVVVVMVVVVVV
1VJLVV1VVVV121VVVJLVVVVZ
VVVVVACVVVVVVVVVVVVV1VVA
LVVVVGIVVVVVVVV1VVVVKVVD
VVJLVVVVVVJLVVVKVVVKVV1D
VVVVVVVVVVVVV1VVVV1VV2AB
CPVVVVABCVVVVBVVVACVVABB
BBCWWWDEFWWWWEWWWDFWWDEE
Back.png
